# 统计列表中的国家代码
AR -> 阿根廷
AU -> 澳大利亚
BG -> 保加利亚
BR -> 巴西
CA -> 加拿大
CN -> 中国
CZ -> 捷克
DE -> 德国
DK -> 丹麦
EE -> 爱沙尼亚
ES -> 西班牙
FI -> 芬兰
FR -> 法国
GB -> 英国
GR -> 希腊
HK -> 香港特别行政区
HU -> 匈牙利
ID -> 印度尼西亚
IL -> 以色列
IS -> 冰岛
IT -> 意大利
JP -> 日本
KR -> 韩国
LT -> 立陶宛
LV -> 拉脱维亚
MT -> 马耳他
MX -> 墨西哥
NL -> 荷兰
NO -> 挪威
PH -> 菲律宾
PL -> 波兰
PT -> 葡萄牙
RO -> 罗马尼亚
RU -> 俄罗斯
SA -> 沙特阿拉伯
SE -> 瑞典
SI -> 斯洛文尼亚
SK -> 斯洛伐克
SV -> 萨尔瓦多
TH -> 泰国
TR -> 土耳其
TW -> 台湾地区
UA -> 乌克兰
US -> 美国
UY -> 乌拉圭
VE -> 委内瑞拉
VN -> 越南
